###################################################################
#                                                                 #
# This Datapack was created by Cosmic_Ronin                       #
#                                                                 #
# --------------------------------------------------------------- #
#                         DATAPACK INFO                           #
# --------------------------------------------------------------- #
#                                                                 #
#     Author: Cosmic_Ronin                                        #
#                                                                 #
#                                                                 #
###################################################################

socreboard objectives add flesh_use dummy